        x     x  x  
  x    x  x   x     
 x x x   x    x     
 x xx  xxx   xx  x  
 xx      x  x   x   
    xx xx    x xx  x
x     x x   x       
x x x   xx  x   xx  
x x          x      
  x xx         x    
   xx x x xx   xx  x
    x x    x x    x 
x    xx x  xx      x
   x       x   x    
  x       x      x  
   x x   x  x x  x  
     x            xx
  x    xx x         
     x   x   x  x   
x   x xxx  x        
