  x x x   x      x x 
   x    x x   xx x   
   x      xx xx   x 
  x    x   xx   x xx
             xx  x x
         xx  x  x   
x xx               x
x   x     xxxxxx   x
 x                 x
               x    
     x  xxx      x  
x   xx         x  xx
    xxx x  x   x xx 
x  x x  x x  x  x  x
x     xx       x x x
x x     x x x  x  xx
x      x x         
  x            xx xx
 x  x        xx   xx
  x           x x   
